00033933000
01220002210
11200000211
00011111000
00111011100
00001110000
00000000000
00000000000
00000000000